050 50
00000000000000000000000000000000000000000000000000
01111111111111111111111111126631111111111111111110
01111111111111111111111111166663111111111111111110
01111111111111111111111111266666663111111111111110
01111111111111111111111112666666666311111111111110
01111111111111111111111266666666666666666666611110
01111111111111111111111666666666666666666666611110
01111111111111111111111666666666666666666666611110
01111111111111111111111466666666666665146666611110
01111111111111111111111146666666666651116666611110
01111111111111111111111116666666666611111111111110
01111111111111111111111116666666666631111111111110
01111126631111111111111116666666666661111111111110
01111266661111111111111116666666666661111112663110
01111666661111111111111116666666666661111116666110
01111666663111111111111116666666666663111126666110
01111666666311111111111116666666666666631266666110
01111466666666631111111116666666666666666666666110
01111146666666661111111126666666666666666666666110
01111114666666661111111266666666666651146666666110
01111112666666651111112666666666666511111114665110
01111116666665111111116666666666666111111111111110
01111116666651111111116666666666666311111111111110
01111116666631266311126666666666666631111111111110
01111116666666666631266666666666666663111111111110
01111116666666666666666666666666666666111111111110
01111114666666666666666666666666666666111111111110
01111111466666666666666666666666666666311111111110
01111111111114666666665146666666654666631111111110
01111111111111466666663114666666511466666311111110
01111111111111146666666111666666311146666631111110
01111111111111126666666111466666631116666663111110
01111111111266666666666311146666666314666666111110
01111111111666666666666631126666666611466666111110
01111111112666666666666663266666666611166666111110
01112666326666666666666666666666666631146665111110
01126666666666666666666666666666666661111111111110
01166666666666666666666666666666666663111111111110
01166666666666666666666666514666666666111111111110
01166666666666666666666665111466666666311111111110
01166666666666666666666651111111146666631111111110
01146666666666666666666511111111111146661111111110
01111111466666666666666311111111111114661111111110
01111111146666666666666631111111111111111111111110
01111111114666666666666663111111111111111111111110
01111111111666666514666666311111111111111111111110
01111111111466665111466666611111111111111111111110
01111111111166661111166666611111111111111111111110
01111111111146651111146666511111111111111111111110
00000000000000000000000000000000000000000000000000
